23432000000000000234
23320022222200002343
02220022333220002343
00000223443220023432
22200223444322023432
33200223443220234320
34320022333220234320
33200222222202343200
22200233222200233200
00002343200000000000
