1111111111111111111111111111111111111111111
1000100010000000100000000000100010000000001
1010111110111110101111110111110111110111101
0010000010000000000100000000000000100010101
1111100111101111101101111101100101111010111
1000100000100000000000100000100100000000001
1011100111110111001110111101111111110111101
1010000000100100000000100001001000100000111
1110111000001100001110011100001010000100001
1010100010000000101000000100100010010100101
1000111110111110101111110111110111110111101
1010000010000000000100000000000000100000101
1011100111101111101101111101111101111000111
1000100000100000000000000000000000000000100
1111100111110111111110111101111111110111101
1000000000100000000000100000000000100000001
1111111111111111111111111111111111111111111
