11111111111111111111
00001000000000001001
11101111101111101001
10101000001000001001
10001011111011111001
10111010000010000001
10000010111110111101
10111110100000100001
10010000001111100000
11111111111111111111
