000000000222000000000233320000
000000222222222000002234322000
000000223333322000002233322000
000000223443322000000222220000
000002223443322000000220000000
000002222344322220000000000000
000000022333322200000000000000
000000022223322200000000000000
000000000222222000000000000000
000000000022220222222229000000
022220000000000223333222000000
222222200000000234432220000000
333332200000000223443220000000
444432220000000223333220000000
333343220000002222222200000000
