00010000000000000000
00010000000000000000
00010001001000010000
00010001001222010000
00010001001000010000
00010001001033310000
00010001001000010000
00010001001444010000
00000001001000010000
00000001001000010000
