10001010100010101010
01010100100101010010
10001001010100101001
01010100101001010100
00101010010100101010
10010100101010010100
01001010010100101001
00100101001010010101
10100010010010100010
00010100001001010010
