01100330011003300110
10101010101010101010
04400110022001100440
00000000000000000000
02200110044001100220
10101010101010101010
01100330011003300110
00000000000000000000
10101010101010101010
11001100110011001100
