11111111111111111111
10000000000000000001
10111111111111111101
10000000000000000001
10001111111111110001
10000000000000010001
10001000000000000001
10001111111111110001
10000000000000000001
11111111111111111111
