00220330440000300440
00220330440220330400
00220330440220330440
00220330440220330400
00220330440220330400
00000000000220330400
00220330440220330400
00220330440220330440
00220330440220330400
00220330440000300440
