00000010000000000000
00000101111100000000
00000101000010000000
00001010111010000000
00001010100101000000
00001010110101000000
00000101000101000000
00000101111010000000
00000010000010000000
00000011111100000000
