00000000001000000000
00000000001000010000
00000000001000010000
01111111111111110000
00000000000000000000
01111111111111110000
00000000001000010000
00000000001000010000
00000000001000010000
00000000001000000000
